date,county,state,fips,cases,deaths,cured
2020-03-11,Miami-Dade,Florida,12086,1,0,1
2020-03-12,Miami-Dade,Florida,12086,2,0,2
2020-03-13,Miami-Dade,Florida,12086,8,0,8
2020-03-14,Miami-Dade,Florida,12086,8,0,8
2020-03-15,Miami-Dade,Florida,12086,13,0,13
2020-03-16,Miami-Dade,Florida,12086,23,0,23
2020-03-17,Miami-Dade,Florida,12086,43,0,43
2020-03-18,Miami-Dade,Florida,12086,77,0,77
2020-03-19,Miami-Dade,Florida,12086,101,0,101
2020-03-20,Miami-Dade,Florida,12086,124,0,124
2020-03-21,Miami-Dade,Florida,12086,170,0,170
2020-03-22,Miami-Dade,Florida,12086,228,0,228
2020-03-23,Miami-Dade,Florida,12086,277,0,277
2020-03-24,Miami-Dade,Florida,12086,365,0,365
2020-03-25,Miami-Dade,Florida,12086,489,0,489
2020-03-26,Miami-Dade,Florida,12086,653,0,653
2020-03-27,Miami-Dade,Florida,12086,869,2,867
2020-03-28,Miami-Dade,Florida,12086,1121,3,1118
2020-03-29,Miami-Dade,Florida,12086,1471,3,1468
2020-03-30,Miami-Dade,Florida,12086,1700,4,1696
2020-03-31,Miami-Dade,Florida,12086,2123,7,2116
2020-04-01,Miami-Dade,Florida,12086,2415,11,2404
2020-04-02,Miami-Dade,Florida,12086,2885,20,2865
2020-04-03,Miami-Dade,Florida,12086,3363,25,3338
2020-04-04,Miami-Dade,Florida,12086,3889,31,3858
2020-04-05,Miami-Dade,Florida,12086,4145,31,4114
2020-04-06,Miami-Dade,Florida,12086,4670,41,4629
2020-04-07,Miami-Dade,Florida,12086,5125,47,5078
2020-04-08,Miami-Dade,Florida,12086,5460,50,5410
2020-04-09,Miami-Dade,Florida,12086,5897,66,5831
2020-04-10,Miami-Dade,Florida,12086,6299,84,6215
2020-04-11,Miami-Dade,Florida,12086,6757,93,6664
2020-04-12,Miami-Dade,Florida,12086,7057,97,6960
2020-04-13,Miami-Dade,Florida,12086,7458,109,7349
2020-04-14,Miami-Dade,Florida,12086,7711,143,7568
2020-04-15,Miami-Dade,Florida,12086,8066,155,7911
2020-04-16,Miami-Dade,Florida,12086,8325,183,8142
2020-04-17,Miami-Dade,Florida,12086,8823,195,8628
2020-04-18,Miami-Dade,Florida,12086,9044,198,8846
2020-04-19,Miami-Dade,Florida,12086,9353,207,9146
2020-04-20,Miami-Dade,Florida,12086,9656,223,9433
2020-04-21,Miami-Dade,Florida,12086,10055,233,9822
2020-04-22,Miami-Dade,Florida,12086,10152,240,9912
2020-04-23,Miami-Dade,Florida,12086,10587,270,10317
2020-04-24,Miami-Dade,Florida,12086,10925,287,10638
2020-04-25,Miami-Dade,Florida,12086,11004,295,10709
2020-04-26,Miami-Dade,Florida,12086,11350,301,11049
2020-04-27,Miami-Dade,Florida,12086,11569,302,11267
2020-04-28,Miami-Dade,Florida,12086,11830,324,11506
2020-04-29,Miami-Dade,Florida,12086,11926,338,11588
2020-04-30,Miami-Dade,Florida,12086,12063,352,11711
2020-05-01,Miami-Dade,Florida,12086,12388,358,12030
2020-05-02,Miami-Dade,Florida,12086,12631,367,12264
2020-05-03,Miami-Dade,Florida,12086,12774,369,12405
2020-05-04,Miami-Dade,Florida,12086,13091,378,12713
2020-05-05,Miami-Dade,Florida,12086,13223,407,12816
2020-05-06,Miami-Dade,Florida,12086,13370,432,12938
2020-05-07,Miami-Dade,Florida,12086,13584,454,13130
2020-05-08,Miami-Dade,Florida,12086,13663,468,13195
2020-05-09,Miami-Dade,Florida,12086,13840,482,13358
2020-05-10,Miami-Dade,Florida,12086,14006,487,13519
2020-05-11,Miami-Dade,Florida,12086,14166,490,13676
2020-05-12,Miami-Dade,Florida,12086,14384,505,13879
2020-05-13,Miami-Dade,Florida,12086,14467,518,13949
2020-05-14,Miami-Dade,Florida,12086,14741,535,14206
2020-05-15,Miami-Dade,Florida,12086,15010,548,14462
2020-05-16,Miami-Dade,Florida,12086,15365,559,14806
2020-05-17,Miami-Dade,Florida,12086,15657,561,15096
2020-05-18,Miami-Dade,Florida,12086,15863,566,15297
2020-05-19,Miami-Dade,Florida,12086,15941,578,15363
2020-05-20,Miami-Dade,Florida,12086,16033,578,15455
2020-05-21,Miami-Dade,Florida,12086,16366,602,15764
2020-05-22,Miami-Dade,Florida,12086,16521,614,15907
2020-05-23,Miami-Dade,Florida,12086,16693,629,16064
2020-05-24,Miami-Dade,Florida,12086,16844,631,16213
2020-05-25,Miami-Dade,Florida,12086,17040,633,16407
2020-05-26,Miami-Dade,Florida,12086,17167,633,16534
2020-05-27,Miami-Dade,Florida,12086,17224,655,16569
2020-05-28,Miami-Dade,Florida,12086,17395,669,16726
2020-05-29,Miami-Dade,Florida,12086,17640,685,16955
2020-05-30,Miami-Dade,Florida,12086,17825,700,17125
2020-05-31,Miami-Dade,Florida,12086,17999,700,17299
2020-06-01,Miami-Dade,Florida,12086,18138,702,17436
2020-06-02,Miami-Dade,Florida,12086,18223,722,17501
2020-06-03,Miami-Dade,Florida,12086,18455,731,17724
2020-06-04,Miami-Dade,Florida,12086,18778,746,18032
2020-06-05,Miami-Dade,Florida,12086,19055,760,18295
2020-06-06,Miami-Dade,Florida,12086,19298,765,18533
2020-06-07,Miami-Dade,Florida,12086,19546,765,18781
2020-06-08,Miami-Dade,Florida,12086,19755,767,18988
2020-06-09,Miami-Dade,Florida,12086,19979,774,19205
2020-06-10,Miami-Dade,Florida,12086,20276,784,19492
2020-06-11,Miami-Dade,Florida,12086,20547,798,19749
2020-06-12,Miami-Dade,Florida,12086,20871,809,20062
2020-06-13,Miami-Dade,Florida,12086,21632,822,20810
2020-06-14,Miami-Dade,Florida,12086,21916,825,21091
2020-06-15,Miami-Dade,Florida,12086,22196,826,21370
2020-06-16,Miami-Dade,Florida,12086,22740,847,21893
2020-06-17,Miami-Dade,Florida,12086,23272,850,22422
2020-06-18,Miami-Dade,Florida,12086,23853,859,22994
2020-06-19,Miami-Dade,Florida,12086,24375,864,23511
2020-06-20,Miami-Dade,Florida,12086,25079,874,24205
2020-06-21,Miami-Dade,Florida,12086,25789,884,24905
2020-06-22,Miami-Dade,Florida,12086,26238,884,25354
2020-06-23,Miami-Dade,Florida,12086,26821,902,25919
2020-06-24,Miami-Dade,Florida,12086,27778,926,26852
2020-06-25,Miami-Dade,Florida,12086,28663,935,27728
2020-06-26,Miami-Dade,Florida,12086,30195,946,29249
2020-06-27,Miami-Dade,Florida,12086,31561,947,30614
2020-06-28,Miami-Dade,Florida,12086,33713,953,32760
2020-06-29,Miami-Dade,Florida,12086,35221,975,34246
2020-06-30,Miami-Dade,Florida,12086,36819,991,35828
2020-07-01,Miami-Dade,Florida,12086,37960,1000,36960
2020-07-02,Miami-Dade,Florida,12086,40264,1018,39246
2020-07-03,Miami-Dade,Florida,12086,42310,1034,41276
2020-07-04,Miami-Dade,Florida,12086,44728,1038,43690
2020-07-05,Miami-Dade,Florida,12086,47010,1043,45967
2020-07-06,Miami-Dade,Florida,12086,48991,1051,47940
2020-07-07,Miami-Dade,Florida,12086,51057,1057,50000
2020-07-08,Miami-Dade,Florida,12086,53973,1068,52905
2020-07-09,Miami-Dade,Florida,12086,55960,1092,54868
2020-07-10,Miami-Dade,Florida,12086,58340,1118,57222
2020-07-11,Miami-Dade,Florida,12086,60867,1132,59735
2020-07-12,Miami-Dade,Florida,12086,64443,1139,63304
2020-07-13,Miami-Dade,Florida,12086,67712,1143,66569
2020-07-14,Miami-Dade,Florida,12086,69802,1175,68627
2020-07-15,Miami-Dade,Florida,12086,72316,1202,71114
2020-07-16,Miami-Dade,Florida,12086,75424,1246,74178
2020-07-17,Miami-Dade,Florida,12086,77866,1270,76596
2020-07-18,Miami-Dade,Florida,12086,81025,1274,79751
2020-07-19,Miami-Dade,Florida,12086,84237,1302,82935
2020-07-20,Miami-Dade,Florida,12086,87034,1309,85725
2020-07-21,Miami-Dade,Florida,12086,89556,1325,88231
2020-07-22,Miami-Dade,Florida,12086,92344,1342,91002
2020-07-23,Miami-Dade,Florida,12086,95067,1354,93713
2020-07-24,Miami-Dade,Florida,12086,98429,1370,97059
2020-07-25,Miami-Dade,Florida,12086,101853,1379,100474
2020-07-26,Miami-Dade,Florida,12086,104754,1388,103366
2020-07-27,Miami-Dade,Florida,12086,107314,1404,105910
2020-07-28,Miami-Dade,Florida,12086,110351,1425,108926
2020-07-29,Miami-Dade,Florida,12086,113142,1455,111687
2020-07-30,Miami-Dade,Florida,12086,115915,1515,114400
2020-07-31,Miami-Dade,Florida,12086,118461,1611,116850
2020-08-01,Miami-Dade,Florida,12086,121206,1647,119559
2020-08-02,Miami-Dade,Florida,12086,122689,1669,121020
2020-08-03,Miami-Dade,Florida,12086,123643,1694,121949
2020-08-04,Miami-Dade,Florida,12086,124758,1724,123034
2020-08-05,Miami-Dade,Florida,12086,125948,1775,124173
2020-08-06,Miami-Dade,Florida,12086,127676,1784,125892
2020-08-07,Miami-Dade,Florida,12086,129408,1809,127599
2020-08-08,Miami-Dade,Florida,12086,131216,1838,129378
2020-08-09,Miami-Dade,Florida,12086,132460,1865,130595
2020-08-10,Miami-Dade,Florida,12086,133622,1874,131748
2020-08-11,Miami-Dade,Florida,12086,135129,1909,133220
2020-08-12,Miami-Dade,Florida,12086,139270,1939,137331
2020-08-13,Miami-Dade,Florida,12086,140983,1954,139029
2020-08-14,Miami-Dade,Florida,12086,142661,1999,140662
2020-08-15,Miami-Dade,Florida,12086,144406,2047,142359
2020-08-16,Miami-Dade,Florida,12086,145306,2057,143249
2020-08-17,Miami-Dade,Florida,12086,146025,2081,143944
2020-08-18,Miami-Dade,Florida,12086,146989,2126,144863
2020-08-19,Miami-Dade,Florida,12086,148092,2166,145926
2020-08-20,Miami-Dade,Florida,12086,149161,2185,146976
2020-08-21,Miami-Dade,Florida,12086,150304,2219,148085
2020-08-22,Miami-Dade,Florida,12086,151213,2238,148975
2020-08-23,Miami-Dade,Florida,12086,151985,2243,149742
2020-08-24,Miami-Dade,Florida,12086,152611,2253,150358
2020-08-25,Miami-Dade,Florida,12086,153384,2277,151107
2020-08-26,Miami-Dade,Florida,12086,154134,2317,151817
2020-08-27,Miami-Dade,Florida,12086,154756,2346,152410
2020-08-28,Miami-Dade,Florida,12086,155417,2372,153045
2020-08-29,Miami-Dade,Florida,12086,156037,2399,153638
2020-08-30,Miami-Dade,Florida,12086,156558,2403,154155
2020-08-31,Miami-Dade,Florida,12086,156909,2437,154472
2020-09-01,Miami-Dade,Florida,12086,159058,2537,156521
2020-09-02,Miami-Dade,Florida,12086,159399,2554,156845
2020-09-03,Miami-Dade,Florida,12086,159977,2600,157377
2020-09-04,Miami-Dade,Florida,12086,160468,2632,157836
2020-09-05,Miami-Dade,Florida,12086,161017,2650,158367
2020-09-06,Miami-Dade,Florida,12086,161362,2655,158707
2020-09-07,Miami-Dade,Florida,12086,161636,2658,158978
2020-09-08,Miami-Dade,Florida,12086,162025,2666,159359
2020-09-09,Miami-Dade,Florida,12086,162432,2740,159692
2020-09-10,Miami-Dade,Florida,12086,162893,2789,160104
2020-09-11,Miami-Dade,Florida,12086,163374,2836,160538
2020-09-12,Miami-Dade,Florida,12086,163789,2882,160907
2020-09-13,Miami-Dade,Florida,12086,164085,2880,161205
2020-09-14,Miami-Dade,Florida,12086,164298,2894,161404
2020-09-15,Miami-Dade,Florida,12086,164687,2923,161764
2020-09-16,Miami-Dade,Florida,12086,165146,2955,162191
2020-09-17,Miami-Dade,Florida,12086,165594,2977,162617
2020-09-18,Miami-Dade,Florida,12086,165979,3027,162952
2020-09-19,Miami-Dade,Florida,12086,166515,3055,163460
2020-09-20,Miami-Dade,Florida,12086,166880,3055,163825
2020-09-21,Miami-Dade,Florida,12086,167152,3055,164097
2020-09-22,Miami-Dade,Florida,12086,167514,3085,164429
2020-09-23,Miami-Dade,Florida,12086,167879,3127,164752
2020-09-24,Miami-Dade,Florida,12086,168271,3163,165108
2020-09-25,Miami-Dade,Florida,12086,168774,3202,165572
2020-09-26,Miami-Dade,Florida,12086,169143,3231,165912
2020-09-27,Miami-Dade,Florida,12086,169425,3231,166194
2020-09-28,Miami-Dade,Florida,12086,169465,3228,166237
2020-09-29,Miami-Dade,Florida,12086,170085,3243,166842
2020-09-30,Miami-Dade,Florida,12086,170399,3280,167119
2020-10-01,Miami-Dade,Florida,12086,170881,3284,167597
2020-10-02,Miami-Dade,Florida,12086,171390,3314,168076
2020-10-03,Miami-Dade,Florida,12086,171875,3330,168545
2020-10-04,Miami-Dade,Florida,12086,172204,3334,168870
2020-10-05,Miami-Dade,Florida,12086,172397,3334,169063
2020-10-06,Miami-Dade,Florida,12086,172848,3349,169499
2020-10-07,Miami-Dade,Florida,12086,173279,3368,169911
2020-10-08,Miami-Dade,Florida,12086,173720,3387,170333
2020-10-09,Miami-Dade,Florida,12086,174111,3409,170702
2020-10-10,Miami-Dade,Florida,12086,174111,3409,170702
2020-10-11,Miami-Dade,Florida,12086,175117,3439,171678
2020-10-12,Miami-Dade,Florida,12086,175396,3445,171951
2020-10-13,Miami-Dade,Florida,12086,175836,3465,172371
2020-10-14,Miami-Dade,Florida,12086,176270,3485,172785
2020-10-15,Miami-Dade,Florida,12086,176808,3501,173307
2020-10-16,Miami-Dade,Florida,12086,177338,3520,173818
2020-10-17,Miami-Dade,Florida,12086,177892,3537,174355
2020-10-18,Miami-Dade,Florida,12086,178353,3540,174813
2020-10-19,Miami-Dade,Florida,12086,178725,3547,175178
2020-10-20,Miami-Dade,Florida,12086,179285,3561,175724
2020-10-21,Miami-Dade,Florida,12086,179643,3572,176071
2020-10-22,Miami-Dade,Florida,12086,180496,3585,176911
2020-10-23,Miami-Dade,Florida,12086,181016,3597,177419
2020-10-24,Miami-Dade,Florida,12086,181632,3605,178027
2020-10-25,Miami-Dade,Florida,12086,181941,3612,178329
2020-10-26,Miami-Dade,Florida,12086,182522,3615,178907
2020-10-27,Miami-Dade,Florida,12086,183249,3624,179625
2020-10-28,Miami-Dade,Florida,12086,183995,3625,180370
2020-10-29,Miami-Dade,Florida,12086,184668,3634,181034
2020-10-30,Miami-Dade,Florida,12086,185551,3643,181908
2020-10-31,Miami-Dade,Florida,12086,185890,3647,182243
2020-11-01,Miami-Dade,Florida,12086,186808,3662,183146
2020-11-02,Miami-Dade,Florida,12086,187756,3669,184087
2020-11-03,Miami-Dade,Florida,12086,188635,3675,184960
2020-11-04,Miami-Dade,Florida,12086,189331,3670,185661
2020-11-05,Miami-Dade,Florida,12086,190727,3670,187057
2020-11-06,Miami-Dade,Florida,12086,191837,3671,188166
2020-11-07,Miami-Dade,Florida,12086,192645,3682,188963
2020-11-08,Miami-Dade,Florida,12086,194355,3683,190672
2020-11-09,Miami-Dade,Florida,12086,194878,3688,191190
2020-11-10,Miami-Dade,Florida,12086,195272,3690,191582
2020-11-11,Miami-Dade,Florida,12086,195990,3693,192297
2020-11-12,Miami-Dade,Florida,12086,197195,3701,193494
2020-11-13,Miami-Dade,Florida,12086,199071,3706,195365
2020-11-14,Miami-Dade,Florida,12086,200258,3707,196551
2020-11-15,Miami-Dade,Florida,12086,202643,3709,198934
2020-11-16,Miami-Dade,Florida,12086,203653,3709,199944
2020-11-17,Miami-Dade,Florida,12086,205535,3723,201812
2020-11-18,Miami-Dade,Florida,12086,207220,3731,203489
2020-11-19,Miami-Dade,Florida,12086,209165,3738,205427
2020-11-20,Miami-Dade,Florida,12086,211256,3746,207510
2020-11-21,Miami-Dade,Florida,12086,213196,3753,209443
2020-11-22,Miami-Dade,Florida,12086,214942,3766,211176
2020-11-23,Miami-Dade,Florida,12086,216441,3782,212659
2020-11-24,Miami-Dade,Florida,12086,218293,3789,214504
2020-11-25,Miami-Dade,Florida,12086,220413,3792,216621
2020-11-26,Miami-Dade,Florida,12086,220413,3792,216621
2020-11-27,Miami-Dade,Florida,12086,224165,3799,220366
2020-11-28,Miami-Dade,Florida,12086,225631,3823,221808
2020-11-29,Miami-Dade,Florida,12086,227655,3834,223821
2020-11-30,Miami-Dade,Florida,12086,229617,3835,225782
2020-12-01,Miami-Dade,Florida,12086,231760,3839,227921
2020-12-02,Miami-Dade,Florida,12086,234053,3860,230193
2020-12-03,Miami-Dade,Florida,12086,236307,3868,232439
2020-12-04,Miami-Dade,Florida,12086,238812,3888,234924
2020-12-05,Miami-Dade,Florida,12086,241050,3896,237154
2020-12-06,Miami-Dade,Florida,12086,243049,3913,239136
2020-12-07,Miami-Dade,Florida,12086,245063,3934,241129
2020-12-08,Miami-Dade,Florida,12086,246914,3926,242988
2020-12-09,Miami-Dade,Florida,12086,249042,3930,245112
2020-12-10,Miami-Dade,Florida,12086,251282,3943,247339
2020-12-11,Miami-Dade,Florida,12086,253402,3959,249443
2020-12-12,Miami-Dade,Florida,12086,255461,3965,251496
2020-12-13,Miami-Dade,Florida,12086,257856,3981,253875
2020-12-14,Miami-Dade,Florida,12086,260137,4002,256135
2020-12-15,Miami-Dade,Florida,12086,262297,4005,258292
2020-12-16,Miami-Dade,Florida,12086,264672,4017,260655
2020-12-17,Miami-Dade,Florida,12086,267254,4022,263232
2020-12-18,Miami-Dade,Florida,12086,269715,4034,265681
2020-12-19,Miami-Dade,Florida,12086,272097,4050,268047
2020-12-20,Miami-Dade,Florida,12086,274116,4066,270050
2020-12-21,Miami-Dade,Florida,12086,276413,4097,272316
2020-12-22,Miami-Dade,Florida,12086,278738,4095,274643
2020-12-23,Miami-Dade,Florida,12086,280981,4096,276885
2020-12-24,Miami-Dade,Florida,12086,283284,4108,279176
2020-12-25,Miami-Dade,Florida,12086,283284,4108,279176
2020-12-26,Miami-Dade,Florida,12086,286661,4127,282534
2020-12-27,Miami-Dade,Florida,12086,288305,4150,284155
2020-12-28,Miami-Dade,Florida,12086,290362,4155,286207
2020-12-29,Miami-Dade,Florida,12086,293187,4164,289023
2020-12-30,Miami-Dade,Florida,12086,295935,4169,291766
2020-12-31,Miami-Dade,Florida,12086,298872,4188,294684
2021-01-01,Miami-Dade,Florida,12086,298872,4188,294684
2021-01-02,Miami-Dade,Florida,12086,304186,4239,299947
2021-01-03,Miami-Dade,Florida,12086,305733,4251,301482
2021-01-04,Miami-Dade,Florida,12086,308258,4256,304002
2021-01-05,Miami-Dade,Florida,12086,311605,4257,307348
2021-01-06,Miami-Dade,Florida,12086,314741,4260,310481
2021-01-07,Miami-Dade,Florida,12086,318114,4297,313817
2021-01-08,Miami-Dade,Florida,12086,321554,4332,317222
2021-01-09,Miami-Dade,Florida,12086,324259,4365,319894
2021-01-10,Miami-Dade,Florida,12086,326606,4413,322193
2021-01-11,Miami-Dade,Florida,12086,328700,4441,324259
2021-01-12,Miami-Dade,Florida,12086,331648,4452,327196
2021-01-13,Miami-Dade,Florida,12086,334216,4472,329744
2021-01-14,Miami-Dade,Florida,12086,336748,4500,332248
2021-01-15,Miami-Dade,Florida,12086,339433,4528,334905
2021-01-16,Miami-Dade,Florida,12086,341841,4561,337280
2021-01-17,Miami-Dade,Florida,12086,344245,4595,339650
2021-01-18,Miami-Dade,Florida,12086,346089,4617,341472
2021-01-19,Miami-Dade,Florida,12086,347964,4622,343342
2021-01-20,Miami-Dade,Florida,12086,350251,4630,345621
2021-01-21,Miami-Dade,Florida,12086,352404,4644,347760
2021-01-22,Miami-Dade,Florida,12086,354703,4678,350025
2021-01-23,Miami-Dade,Florida,12086,357037,4703,352334
2021-01-24,Miami-Dade,Florida,12086,358800,4730,354070
2021-01-25,Miami-Dade,Florida,12086,360830,4747,356083
2021-01-26,Miami-Dade,Florida,12086,362600,4759,357841
2021-01-27,Miami-Dade,Florida,12086,364122,4768,359354
2021-01-28,Miami-Dade,Florida,12086,366126,4797,361329
2021-01-29,Miami-Dade,Florida,12086,368136,4817,363319
2021-01-30,Miami-Dade,Florida,12086,370641,4845,365796
2021-01-31,Miami-Dade,Florida,12086,372119,4874,367245
2021-02-01,Miami-Dade,Florida,12086,373422,4905,368517
2021-02-02,Miami-Dade,Florida,12086,375321,4907,370414
2021-02-03,Miami-Dade,Florida,12086,376551,4919,371632
2021-02-04,Miami-Dade,Florida,12086,377998,4942,373056
2021-02-05,Miami-Dade,Florida,12086,380715,4964,375751
2021-02-06,Miami-Dade,Florida,12086,382185,4979,377206
2021-02-07,Miami-Dade,Florida,12086,383600,5011,378589
2021-02-08,Miami-Dade,Florida,12086,384970,5039,379931
2021-02-09,Miami-Dade,Florida,12086,386424,5058,381366
2021-02-10,Miami-Dade,Florida,12086,387939,5062,382877
2021-02-11,Miami-Dade,Florida,12086,389518,5081,384437
2021-02-12,Miami-Dade,Florida,12086,391161,5121,386040
2021-02-13,Miami-Dade,Florida,12086,392841,5141,387700
2021-02-14,Miami-Dade,Florida,12086,393970,5170,388800
2021-02-15,Miami-Dade,Florida,12086,394491,5185,389306
2021-02-16,Miami-Dade,Florida,12086,395827,5207,390620
2021-02-17,Miami-Dade,Florida,12086,397225,5229,391996
2021-02-18,Miami-Dade,Florida,12086,398042,5242,392800
2021-02-19,Miami-Dade,Florida,12086,399592,5270,394322
2021-02-20,Miami-Dade,Florida,12086,401136,5280,395856
2021-02-21,Miami-Dade,Florida,12086,402264,5290,396974
2021-02-22,Miami-Dade,Florida,12086,403258,5314,397944
2021-02-23,Miami-Dade,Florida,12086,404498,5338,399160
2021-02-24,Miami-Dade,Florida,12086,405562,5353,400209
2021-02-25,Miami-Dade,Florida,12086,406986,5369,401617
2021-02-26,Miami-Dade,Florida,12086,408095,5396,402699
2021-02-27,Miami-Dade,Florida,12086,409215,5422,403793
2021-02-28,Miami-Dade,Florida,12086,410716,5429,405287
2021-03-01,Miami-Dade,Florida,12086,410951,5449,405502
2021-03-02,Miami-Dade,Florida,12086,412907,5481,407426
2021-03-03,Miami-Dade,Florida,12086,414775,5503,409272
2021-03-04,Miami-Dade,Florida,12086,416020,5511,410509
2021-03-05,Miami-Dade,Florida,12086,417446,5530,411916
2021-03-06,Miami-Dade,Florida,12086,418410,5554,412856
2021-03-07,Miami-Dade,Florida,12086,419478,5558,413920
2021-03-08,Miami-Dade,Florida,12086,420339,5560,414779
2021-03-09,Miami-Dade,Florida,12086,421432,5612,415820
2021-03-10,Miami-Dade,Florida,12086,422539,5619,416920
2021-03-11,Miami-Dade,Florida,12086,423713,5619,418094
2021-03-12,Miami-Dade,Florida,12086,424902,5638,419264
2021-03-13,Miami-Dade,Florida,12086,426148,5651,420497
2021-03-14,Miami-Dade,Florida,12086,426899,5660,421239
2021-03-15,Miami-Dade,Florida,12086,427599,5669,421930
2021-03-16,Miami-Dade,Florida,12086,428872,5688,423184
2021-03-17,Miami-Dade,Florida,12086,429833,5699,424134
2021-03-18,Miami-Dade,Florida,12086,430941,5710,425231
2021-03-19,Miami-Dade,Florida,12086,432176,5716,426460
2021-03-20,Miami-Dade,Florida,12086,433451,5724,427727
2021-03-21,Miami-Dade,Florida,12086,434351,5725,428626
2021-03-22,Miami-Dade,Florida,12086,435134,5728,429406
2021-03-23,Miami-Dade,Florida,12086,436393,5742,430651
2021-03-24,Miami-Dade,Florida,12086,437451,5751,431700
2021-03-25,Miami-Dade,Florida,12086,438703,5767,432936
2021-03-26,Miami-Dade,Florida,12086,439969,5792,434177
2021-03-27,Miami-Dade,Florida,12086,441274,5797,435477
2021-03-28,Miami-Dade,Florida,12086,442336,5814,436522
2021-03-29,Miami-Dade,Florida,12086,443206,5815,437391
2021-03-30,Miami-Dade,Florida,12086,444486,5845,438641
2021-03-31,Miami-Dade,Florida,12086,445463,5855,439608
2021-04-01,Miami-Dade,Florida,12086,447041,5878,441163
2021-04-02,Miami-Dade,Florida,12086,448478,5890,442588
2021-04-03,Miami-Dade,Florida,12086,449890,5900,443990
2021-04-04,Miami-Dade,Florida,12086,451018,5917,445101
2021-04-05,Miami-Dade,Florida,12086,451828,5917,445911
2021-04-06,Miami-Dade,Florida,12086,453344,5924,447420
2021-04-07,Miami-Dade,Florida,12086,454404,5930,448474
2021-04-08,Miami-Dade,Florida,12086,456316,5940,450376
2021-04-09,Miami-Dade,Florida,12086,457917,5954,451963
2021-04-10,Miami-Dade,Florida,12086,459492,5969,453523
2021-04-11,Miami-Dade,Florida,12086,460652,5981,454671
2021-04-12,Miami-Dade,Florida,12086,461040,5980,455060
2021-04-13,Miami-Dade,Florida,12086,463364,5993,457371
2021-04-14,Miami-Dade,Florida,12086,464556,5996,458560
2021-04-15,Miami-Dade,Florida,12086,465999,6014,459985
2021-04-16,Miami-Dade,Florida,12086,467463,6029,461434
2021-04-17,Miami-Dade,Florida,12086,468907,6043,462864
2021-04-18,Miami-Dade,Florida,12086,470667,6044,464623
2021-04-19,Miami-Dade,Florida,12086,471594,6049,465545
2021-04-20,Miami-Dade,Florida,12086,472940,6058,466882
2021-04-21,Miami-Dade,Florida,12086,474068,6059,468009
2021-04-22,Miami-Dade,Florida,12086,475230,6077,469153
2021-04-23,Miami-Dade,Florida,12086,476285,6089,470196
2021-04-24,Miami-Dade,Florida,12086,477781,6097,471684
2021-04-25,Miami-Dade,Florida,12086,478659,6112,472547
2021-04-26,Miami-Dade,Florida,12086,479425,6125,473300
2021-04-27,Miami-Dade,Florida,12086,480482,6130,474352
2021-04-28,Miami-Dade,Florida,12086,481396,6140,475256
2021-04-29,Miami-Dade,Florida,12086,482442,6141,476301
2021-04-30,Miami-Dade,Florida,12086,483370,6159,477211
2021-05-01,Miami-Dade,Florida,12086,484513,6175,478338
2021-05-02,Miami-Dade,Florida,12086,485299,6182,479117
2021-05-03,Miami-Dade,Florida,12086,486024,6186,479838
2021-05-04,Miami-Dade,Florida,12086,486807,6206,480601
2021-05-05,Miami-Dade,Florida,12086,487543,6207,481336
2021-05-06,Miami-Dade,Florida,12086,488302,6218,482084
2021-05-07,Miami-Dade,Florida,12086,489013,6232,482781
2021-05-08,Miami-Dade,Florida,12086,489838,6246,483592
2021-05-09,Miami-Dade,Florida,12086,490498,6252,484246
2021-05-10,Miami-Dade,Florida,12086,491027,6259,484768
2021-05-11,Miami-Dade,Florida,12086,491702,6273,485429
2021-05-12,Miami-Dade,Florida,12086,492231,6275,485956
2021-05-13,Miami-Dade,Florida,12086,493006,6278,486728
2021-05-14,Miami-Dade,Florida,12086,493722,6290,487432
2021-05-15,Miami-Dade,Florida,12086,494373,6302,488071
2021-05-16,Miami-Dade,Florida,12086,494902,6304,488598
2021-05-17,Miami-Dade,Florida,12086,495366,6319,489047
2021-05-18,Miami-Dade,Florida,12086,495920,6333,489587
2021-05-19,Miami-Dade,Florida,12086,496421,6334,490087
2021-05-20,Miami-Dade,Florida,12086,496960,6344,490616
2021-05-21,Miami-Dade,Florida,12086,497370,6363,491007
2021-05-22,Miami-Dade,Florida,12086,498093,6369,491724
2021-05-23,Miami-Dade,Florida,12086,498556,6371,492185
2021-05-24,Miami-Dade,Florida,12086,498952,6372,492580
2021-05-25,Miami-Dade,Florida,12086,499200,6399,492801
2021-05-26,Miami-Dade,Florida,12086,499511,6401,493110
2021-05-27,Miami-Dade,Florida,12086,499955,6412,493543
2021-05-28,Miami-Dade,Florida,12086,500322,6424,493898
2021-05-29,Miami-Dade,Florida,12086,500322,6424,493898
2021-05-30,Miami-Dade,Florida,12086,500322,6424,493898
2021-05-31,Miami-Dade,Florida,12086,500322,6424,493898
2021-06-01,Miami-Dade,Florida,12086,501422,6440,494982
2021-06-02,Miami-Dade,Florida,12086,501638,6457,495181
2021-06-03,Miami-Dade,Florida,12086,501925,6472,495453
2021-06-04,Miami-Dade,Florida,12086,495624,6472,489152
2021-06-05,Miami-Dade,Florida,12086,495624,6472,489152
2021-06-06,Miami-Dade,Florida,12086,495624,6472,489152
2021-06-07,Miami-Dade,Florida,12086,495624,6472,489152
2021-06-08,Miami-Dade,Florida,12086,495624,6472,489152
2021-06-09,Miami-Dade,Florida,12086,495624,6472,489152
2021-06-10,Miami-Dade,Florida,12086,495624,6472,489152
2021-06-11,Miami-Dade,Florida,12086,497726,6472,491254
2021-06-12,Miami-Dade,Florida,12086,497726,6472,491254
2021-06-13,Miami-Dade,Florida,12086,497726,6472,491254
2021-06-14,Miami-Dade,Florida,12086,497726,6472,491254
2021-06-15,Miami-Dade,Florida,12086,497726,6472,491254
2021-06-16,Miami-Dade,Florida,12086,497726,6472,491254
2021-06-17,Miami-Dade,Florida,12086,497726,6472,491254
2021-06-18,Miami-Dade,Florida,12086,499504,6472,493032
2021-06-19,Miami-Dade,Florida,12086,499504,6472,493032
2021-06-20,Miami-Dade,Florida,12086,499504,6472,493032
2021-06-21,Miami-Dade,Florida,12086,499504,6472,493032
2021-06-22,Miami-Dade,Florida,12086,499504,6472,493032
2021-06-23,Miami-Dade,Florida,12086,499504,6472,493032
2021-06-24,Miami-Dade,Florida,12086,499504,6472,493032
2021-06-25,Miami-Dade,Florida,12086,501540,6472,495068
2021-06-26,Miami-Dade,Florida,12086,501540,6472,495068
2021-06-27,Miami-Dade,Florida,12086,501540,6472,495068
2021-06-28,Miami-Dade,Florida,12086,501540,6472,495068
2021-06-29,Miami-Dade,Florida,12086,501540,6472,495068
2021-06-30,Miami-Dade,Florida,12086,501540,6472,495068
